###                 #########
#   ###################   # #
# ####                # # # #
# ################### # # # #
#                     # # # #
##################### # # # #
#  |##||||||||        # # # #
# #|##|### ##|######### # # #
# #||||#   ##B#         # # #
# #|##|################ # # #
###|##||||||||     #### # # #
###|############## ## # # # #
###|||||||||||||##    # # # #
######|########|####### # # #
######|#### |||||       #   #
A||||||######################

Total Explored: 57