###                 #########
#   ###################   # #
# ####                # # # #
# ################### # # # #
#                     # # # #
##################### # # # #
#   ##||||||||        # # # #
# # ##|### ##|######### # # #
# #||||#   ##B#         # # #
# #|## ################ # # #
###|##             #### # # #
###|############## ## # # # #
###||||         ##    # # # #
######|######## ####### # # #
######|####             #   #
A||||||######################
