###                 #########
#   ###################   # #
# ####                # # # #
# ################### # # # #
#                     # # # #
##################### # # # #
#   ##||||||||        # # # #
# # ##|### ##|######### # # #
# #||||#   ##B#         # # #
# #|##|################ # # #
###|##|||||||||||||#### # # #
###|##############|## # # # #
###|||||||||||||##|   # # # #
######|########|####### # # #
######|####|||||||||||  #   #
A||||||######################

Total Explored: 68